############
#..........#
#....~~....#
#....D.....#
#..........#
############

