................
....,,,.........
...,,,,,........
..,,~~~,,.......
..,,~~~,,.......
...,,,,,........
....,,,.........
................

